hobbits:30
delay:5.0
message:none
goal:none
treasures:4
lost:20
bonus:Obstacle,Obstacle,Obstacle,Obstacle
###############################
###################         ###
##############   ## ###########
###              ## # O      ##
### ### ### ### ### # >########
### # # # # # # ### #        ##
X##I# ### ### #I###############
